1111111111
1C01000001
1000011101
1000011101
1000011101
1000011101
1P0011E001
1111111111
